0000000000000000000000000
0000000000000000000000000
00B0000B0000B0000B0000B00
0000000000000000000000000
0000000000000000000000000
0000000000000000000000000
0000000000000000000000000
00B0000B0000B0000B0000B00
0000000000000000000000000
0000000000000000000000000
0000000000000000000000000
0000000000000000000000000
00B0000B0000B0000B0000B00
0000000000000000000000000
0000000000000000000000000
0000000000000000000000000
0000000000000000000000000
00B0000B0000B0000B0000B00
0000000000000000000000000
0000000000000000000000000
0000000000111110000000000
0000000000111110000000000
00B0000B0011b1100B0000B00
0000000000111110000000000
0000000000111110000000000